Dag! - (Guten) Tag!
allemaal - alle, alles, allerseits
lezen - lesen
meelezen - mitlesen
daarna - darnach
hardop - laut
He! - He!
de lieverd - Liebling
Hallo! - Hallo!
fijn - toll
wat fijn - wie toll
weerzien - wiedersehen
Dank je wel. - Danke. (informell)
Hoi! - Hi!
zijn - sein
de vriendin - die Freundin
van - von
hier - hier
de vakantie - der Urlaub
heten - heissen
waar ... vandaan - woher
uit - aus
Zwitserland - Schweiz
wonen - wohnen
de buurt - die Naehe
pap - Papa
terug - zurueck
heel - sehr, ganz
moe - muede
ja - ja
Goedemiddag! - Guten Tag!
meneer - Herr (Anrede)
wie - wer
Dank u wel. - Danke. (formell)