doen - machen, tun
de les - der Unterricht, die Lektion
het plaatje - die Abbildung
schrijven - schreiben
antwoorden - antworten
vragen - fragen
de docent - der Dozent, der Kursleiter
proberen - probieren
zelf - selbst
Sorry. - Entschuldigung.
alstublieft - Bitte (formell)
alsjeblieft - Bitte (formell)
herhalen - wiederholen
misschien - vielleicht
langzaam - langsam
hard - laut
het bord - die Tafel
begrijpen - verstehen
uitleggen - erklaeren
heit Duits - das Deutsche
zien - sehen
het lokaal - der Raum, der Klassenraum
de cd/speler - der CD/Player
het etui - die Federmappe
de poster - das Poster
de cd - die CD
de pen - der Stift
de map - die Mappe
de tas - die Tasche
de stoel - der Stuhl
het krijtje - die Kreide
meer - mehr
het raam - das Fenster
de partner - der Partner